xxxxxxxxxxxxxxxxxxxx-
x.........x....5...x-
x.xx.x.xx.x.xxx.xx.x-
x.....sx.....xx....x-
x.x.xx...x.x..x.xxxx-
x...xx.x.x.xx..s.xoo-
xxx...........xx.xoo-
oox.xx.xx.xxx..x.xoo-
oox.xx.xp...xx...xoo-
xxx.xx.x.xx....x.xxx-
t........xx.x.xx...t-
xxx.xx.x....x..x.xxx-
oox.xx.xxx.xxx.....x-
oox............x.x.x-
oox.xx.xxx.x.xxx...x-
xxx.xx.x...x.x...xxx-
x...s....x.....xs..x-
x.xx.xx.xx.x.x.xxx.x-
x1..3......x2...4..x-
xxxxxxxxxxxxxxxxxxxx-